..........
..........
..........
..........
..........
..........
..........
..........
@.........
##########